
C 226,30,0
F 2,1,100



NO ./texturs/1.xpm
SO ./texturs/2.xpm
WE ./texturs/3.xpm
EA ./texturs/4.xpm

   1111
   1001
    1E01
     111